###############
#+ #    ###  ##
# ## ## #### ##
#    ##      ##
## #### #######
## ####    *###
###############
