####################
####################
####################
####################
####################
####################
####################
######       #######
###### ##### #######
###### ##### #######
###### ##    #######
###### #############
######         #####
############## #####
############## #####
############## #####
############## #####
############## #####
############## #####
##############*#####
####################

