###############
#* #    ###  ##
# ## ## #### ##
#    ##      ##
## #### #######
## ####    +###
###############
