####################
#  ######## #### ###
##  #####    ###+###
### #  #####     ###
### ## ########  ###
### ##  ##  #### ###
### ## ####  ### ###
#      #### #### ###
### # ####       ###
##### ####### ## ###
#  ##   ###   ## ###
## #### ######## ###
##       *##  ## ###
####### ##   ### ###
##   ## ####  ## ###
#### ## #### ### ###
##      ###      ###
####### ######## ###
#                ###
## ## ### #### #####
####################

